23 23 23 23 23 23 23 23 23 23 23 23 23 3 613
0 1 1 1 1 1 1 1 1 23 1 1 1 23 12
10 11 11 11 11 11 11 24 11 23 11 23 11 23 12
10 11 11 11 11 11 11 23 11 23 11 23 11 23 12
10 11 11 23 11 11 11 23 11 23 11 23 11 23 12
10 11 11 23 11 11 11 23 11 23 11 23 11 23 12
10 11 11 11 11 11 11 23 11 23 11 23 11 23 12
10 23 50 23 11 11 11 23 11 23 11 23 11 23 12
50 23 613 23 11 11 11 23 11 11 11 23 11 11 12
23 23 23 23 23 23 23 23 23 23 23 23 23 23 23
